Quelles sont les équipes de football en France ?	trouver les équipes
Donnez-moi la liste des clubs de football en Allemagne.	trouver les équipes
Quelles équipes de football sont basées en Angleterre ?	trouver les équipes
Je voudrais connaître les clubs de football qui jouent en Italie.	trouver les équipes
Quelles sont les équipes nationales de football de l'Espagne ?	trouver les équipes
Quels sont les clubs de football en Argentine ?	trouver les équipes
Indiquez-moi les équipes de football en Belgique.	trouver les équipes
Je souhaite découvrir les clubs de football aux Pays-Bas.	trouver les équipes
Quelles équipes de football sont présentes au Brésil ?	trouver les équipes
Donnez-moi la liste des clubs de football en Turquie.	trouver les équipes
Quelles sont les équipes nationales de football de l'Allemagne ?	trouver les équipes
Je voudrais connaître les équipes de football en Espagne.	trouver les équipes
Quels sont les clubs de football en Angleterre ?	trouver les équipes
Indiquez-moi les équipes de football en Italie.	trouver les équipes
Je souhaite découvrir les clubs de football en France.	trouver les équipes
Quelles équipes de football sont basées en Russie ?	trouver les équipes
Donnez-moi la liste des clubs de football au Portugal.	trouver les équipes
Quelles sont les équipes de football en Argentine ?	trouver les équipes
Quels sont les clubs de football en Écosse ?	trouver les équipes
Indiquez-moi les équipes de football aux États-Unis.	trouver les équipes
Je voudrais connaître les équipes nationales de football du Brésil.	trouver les équipes
Quelles équipes de football sont présentes en Allemagne ?	trouver les équipes
Donnez-moi la liste des clubs de football en Espagne.	trouver les équipes
Quelles sont les équipes de football en Belgique ?	trouver les équipes
Je souhaite découvrir les clubs de football en Italie.	trouver les équipes
Quels sont les clubs de football en France ?	trouver les équipes
Indiquez-moi les équipes de football en Angleterre.	trouver les équipes
Je voudrais connaître les équipes de football en Hollande.	trouver les équipes
Quelles équipes de football sont basées en Écosse ?	trouver les équipes
Donnez-moi la liste des clubs de football en Suède.	trouver les équipes
Quelles sont les équipes nationales de football de l'Argentine ?	trouver les équipes
Je voudrais connaître les équipes de football en Russie.	trouver les équipes
Quels sont les clubs de football en Australie ?	trouver les équipes
Indiquez-moi les équipes de football en Grèce.	trouver les équipes
Je souhaite découvrir les clubs de football en Portugal.	trouver les équipes
Quelles équipes de football sont présentes en Turquie ?	trouver les équipes
Donnez-moi la liste des clubs de football en Colombie.	trouver les équipes
Quelles sont les équipes de football en Uruguay ?	trouver les équipes
Quels sont les clubs de football en Mexique ?	trouver les équipes
Indiquez-moi les équipes de football en Suisse.	trouver les équipes
Quels sont les clubs de football en Espagne ?	trouver les équipes
Montrez-moi la liste des équipes de football en Allemagne.	trouver les équipes
Quelles équipes jouent dans le championnat de France ?	trouver les équipes
Donnez-moi les noms des clubs de football en Angleterre.	trouver les équipes
Quels sont les clubs nationaux de football en Italie ?	trouver les équipes
Quelles équipes de football sont basées au Brésil ?	trouver les équipes
Je souhaite connaître les clubs de football en Argentine.	trouver les équipes
Quels clubs participent à la ligue de football en Belgique ?	trouver les équipes
Quelles équipes de football sont présentes en Hollande ?	trouver les équipes
Indiquez-moi les clubs de football en Turquie.	trouver les équipes
Montrez-moi les équipes de football en Suède.	trouver les équipes
Quels sont les clubs de football professionnels en Écosse ?	trouver les équipes
Quelles équipes jouent dans la Liga portugaise ?	trouver les équipes
Donnez-moi la liste des clubs de football en Russie.	trouver les équipes
Quels sont les clubs de football en Suisse ?	trouver les équipes
Je souhaite connaître les équipes de football en Grèce.	trouver les équipes
Quelles équipes participent au championnat de football en Colombie ?	trouver les équipes
Indiquez-moi les clubs de football en Uruguay.	trouver les équipes
Montrez-moi les équipes de football en Australie.	trouver les équipes
Quels sont les clubs nationaux de football en Mexique ?	trouver les équipes
Quelles équipes jouent dans la Super League chinoise ?	trouver les équipes
Donnez-moi la liste des clubs de football en Corée du Sud.	trouver les équipes
Quels sont les clubs de football en Égypte ?	trouver les équipes
Je souhaite connaître les équipes de football en Arabie saoudite.	trouver les équipes
Quelles équipes participent au championnat de football en Argentine ?	trouver les équipes
Indiquez-moi les clubs de football en Norvège.	trouver les équipes
Montrez-moi les équipes de football en Pologne.	trouver les équipes
Quels sont les clubs de football en Autriche ?	trouver les équipes
Donnez-moi la liste des clubs de football au Danemark.	trouver les équipes
Quelles équipes jouent dans la Liga MX au Mexique ?	trouver les équipes
Je souhaite connaître les équipes de football en Croatie.	trouver les équipes
Quels sont les clubs de football en Irlande ?	trouver les équipes
Indiquez-moi les équipes de football en Équateur.	trouver les équipes
Montrez-moi les clubs de football en Roumanie.	trouver les équipes
Quelles équipes participent au championnat de football en Suède ?	trouver les équipes
Donnez-moi la liste des clubs de football en Bulgarie.	trouver les équipes
Quels sont les clubs de football en Serbie ?	trouver les équipes
Je souhaite connaître les équipes de football en Écosse.	trouver les équipes
Quelles équipes jouent dans la Süper Lig en Turquie ?	trouver les équipes
Indiquez-moi les clubs de football en Ukraine.	trouver les équipes
Montrez-moi les équipes de football en Hongrie.	trouver les équipes
Quels sont les clubs de football en Slovaquie ?	trouver les équipes
Donnez-moi la liste des clubs de football en Belgique.	trouver les équipes
Quelles équipes participent au championnat de football en Norvège ?	trouver les équipes
Je souhaite connaître les équipes de football en Irlande.	trouver les équipes
Quels sont les clubs de football en Finlande ?	trouver les équipes
Indiquez-moi les équipes de football en Chine.	trouver les équipes
Montrez-moi les clubs de football en Arabie saoudite.	trouver les équipes
Quelles équipes jouent dans la ligue de football en Grèce ?	trouver les équipes
Donnez-moi la liste des clubs de football au Portugal.	trouver les équipes
Quels sont les clubs de football en Uruguay ?	trouver les équipes
Je souhaite connaître les équipes de football en Slovénie.	trouver les équipes
Quelles équipes participent au championnat de football en Pologne ?	trouver les équipes
Indiquez-moi les clubs de football en Tunisie.	trouver les équipes
Montrez-moi les équipes de football en Israël.	trouver les équipes
Quels sont les clubs de football en République tchèque ?	trouver les équipes
Donnez-moi la liste des clubs de football en Égypte.	trouver les équipes
Quelles équipes jouent dans la Serie A en Italie ?	trouver les équipes
Je souhaite connaître les équipes de football en Bulgarie.	trouver les équipes
Quels sont les clubs de football en Iran ?	trouver les équipes
Indiquez-moi les équipes de football en Australie.	trouver les équipes
Montrez-moi les clubs de football en Croatie.	trouver les équipes
Quelles équipes participent au championnat de football en Autriche ?	trouver les équipes
Donnez-moi la liste des clubs de football en Hongrie.	trouver les équipes
Quels sont les clubs de football en Lettonie ?	trouver les équipes
Je souhaite connaître les équipes de football en Lituanie.	trouver les équipes
Quelles équipes jouent dans la Liga NOS au Portugal ?	trouver les équipes
Indiquez-moi les clubs de football en Slovaquie.	trouver les équipes
Montrez-moi les équipes de football en Bosnie-Herzégovine.	trouver les équipes
Quels sont les clubs de football en Malaisie ?	trouver les équipes
Donnez-moi la liste des clubs de football en Biélorussie.	trouver les équipes
Quelles équipes participent au championnat de football en Lettonie ?	trouver les équipes
Je souhaite connaître les équipes de football en Moldavie.	trouver les équipes
Quels sont les clubs de football en Thaïlande ?	trouver les équipes
Indiquez-moi les équipes de football en Slovénie.	trouver les équipes
Montrez-moi les clubs de football en Albanie.	trouver les équipes
Quelles équipes jouent dans la Süper Lig en Turquie ?	trouver les équipes
Donnez-moi la liste des clubs de football en Kazakhstan.	trouver les équipes
Quels sont les clubs de football en Géorgie ?	trouver les équipes
Je souhaite connaître les équipes de football en Macédoine du Nord.	trouver les équipes
Quelles équipes participent au championnat de football en Arménie ?	trouver les équipes
Indiquez-moi les clubs de football en Bulgarie.	trouver les équipes
Montrez-moi les équipes de football en Lituanie.	trouver les équipes
Quels sont les clubs de football en Estonie ?	trouver les équipes
Donnez-moi la liste des clubs de football en Albanie.	trouver les équipes
Quelles équipes jouent dans la Liga Profesional en Équateur ?	trouver les équipes
Je souhaite connaître les équipes de football en Luxembourg.	trouver les équipes
Quels sont les clubs de football en Biélorussie ?	trouver les équipes
Indiquez-moi les équipes de football en Chypre.	trouver les équipes
Montrez-moi les clubs de football en Macédoine du Nord.	trouver les équipes
Quelles équipes participent au championnat de football en Kazakhstan ?	trouver les équipes
Donnez-moi la liste des clubs de football en Arménie.	trouver les équipes
Quels sont les clubs de football en Malte ?	trouver les équipes
Je souhaite connaître les équipes de football en Islande.	trouver les équipes
Quelles équipes jouent dans la Liga MX au Mexique ?	trouver les équipes
Indiquez-moi les clubs de football en Israël.	trouver les équipes
Montrez-moi les équipes de football en Roumanie.	trouver les équipes
Quels sont les clubs de football en Moldavie ?	trouver les équipes
Donnez-moi la liste des clubs de football en Azerbaïdjan.	trouver les équipes
Quelles équipes participent au championnat de football en Lituanie ?	trouver les équipes
Quel est le classement actuel de la Liga pour la saison 2022-2023 ?	Demande de classement
Donnez-moi le tableau de classement de la Premier League pour la saison 2023-2024.	Demande de classement
Je souhaite connaître le classement complet de la Serie A pour la saison 2021-2022.	Demande de classement
Quelle est la position actuelle de mon équipe préférée dans la Bundesliga pour la saison 2022-2023 ?	Demande de classement
Quels sont les meilleurs clubs de la Ligue 1 pour la saison 2022-2023 ?	Demande de classement
Indiquez-moi le classement actualisé de la MLS pour la saison 2022.	Demande de classement
Pouvez-vous me fournir le classement détaillé de la Liga MX pour la saison 2022-2023 ?	Demande de classement
Quels sont les leaders du championnat dans la Super League chinoise pour la saison 2022 ?	Demande de classement
Montrez-moi le classement actuel de la J1 League pour la saison 2023.	Demande de classement
Je souhaite connaître le classement complet de la Scottish Premiership pour la saison 2022-2023.	Demande de classement
Quelle est la position actuelle de mon équipe préférée dans la Liga NOS pour la saison 2022-2023 ?	Demande de classement
Donnez-moi le classement de la Major League Soccer pour la saison 2022.	Demande de classement
Quels sont les meilleurs clubs de la Primeira Liga pour la saison 2022-2023 ?	Demande de classement
Indiquez-moi le classement actualisé de la Serie A brésilienne pour la saison 2023.	Demande de classement
Pouvez-vous me fournir le classement détaillé de la Pro League belge pour la saison 2022-2023 ?	Demande de classement
Quels sont les leaders du championnat dans la Süper Lig pour la saison 2022-2023 ?	Demande de classement
Montrez-moi le classement actuel de la Liga Pro en Équateur pour la saison 2022.	Demande de classement
Je souhaite connaître le classement complet de la Superliga argentine pour la saison 2023.	Demande de classement
Quelle est la position actuelle de mon équipe préférée dans la Ligue des Champions pour la saison 2022-2023 ?	Demande de classement
Donnez-moi le classement de la Premier Division irlandaise pour la saison 2022.	Demande de classement
Quels sont les meilleurs clubs de la Russian Premier League pour la saison 2022-2023 ?	Demande de classement
Indiquez-moi le classement actualisé de la LigaPro en Portugal pour la saison 2022-2023.	Demande de classement
Pouvez-vous me fournir le classement détaillé de la Superliga grecque pour la saison 2023.	Demande de classement
Quels sont les leaders du championnat dans la Veikkausliiga finlandaise pour la saison 2022 ?	Demande de classement
Montrez-moi le classement actuel de la Premier Soccer League sud-africaine pour la saison 2022-2023.	Demande de classement
Je souhaite connaître le classement complet de la A-League australienne pour la saison 2023.	Demande de classement
Quelle est la position actuelle de mon équipe préférée dans la LigaPro en Équateur pour la saison 2022 ?	Demande de classement
Donnez-moi le classement de la Superliga danoise pour la saison 2022-2023.	Demande de classement
Quels sont les meilleurs clubs de la Scottish Championship pour la saison 2022-2023 ?	Demande de classement
Indiquez-moi le classement actualisé de la J2 League pour la saison 2023.	Demande de classement
Pouvez-vous me fournir le classement détaillé de la Major League Soccer pour la saison 2022 ?	Demande de classement
Quels sont les leaders du championnat dans la Allsvenskan suédoise pour la saison 2022 ?	Demande de classement
Montrez-moi le classement actuel de la Eliteserien norvégienne pour la saison 2023.	Demande de classement
Je souhaite connaître le classement complet de la Liga MX pour la saison 2022-2023.	Demande de classement
Quelle est la position actuelle de mon équipe préférée dans la K League 1 pour la saison 2022 ?	Demande de classement
Donnez-moi le classement de la LigaPro en Portugal pour la saison 2022-2023.	Demande de classement
Quels sont les meilleurs clubs de la Eredivisie pour la saison 2022-2023 ?	Demande de classement
Indiquez-moi le classement actualisé de la Serie A brésilienne pour la saison 2023.	Demande de classement
Pouvez-vous me fournir le classement détaillé de la Premier League pour la saison 2022-2023.	Demande de classement
Quels sont les leaders du championnat dans la Süper Lig pour la saison 2022-2023.	Demande de classement
Montrez-moi le classement actuel de la LigaPro en Équateur pour la saison 2022-2023.	Demande de classement
Je souhaite connaître le classement complet de la Superliga argentine pour la saison 2023.	Demande de classement
Quelle est la position actuelle de mon équipe préférée dans la Premier Division irlandaise pour la saison 2022.	Demande de classement
Donnez-moi le classement de la Russian Premier League pour la saison 2022-2023.	Demande de classement
Quels sont les meilleurs clubs de la LigaPro en Portugal pour la saison 2022-2023.	Demande de classement
Indiquez-moi le classement actualisé de la Premier Soccer League sud-africaine pour la saison 2022-2023.	Demande de classement
Pouvez-vous me fournir le classement détaillé de la A-League australienne pour la saison 2023.	Demande de classement
Quels sont les leaders du championnat dans la Superliga danoise pour la saison 2022-2023.	Demande de classement
Montrez-moi le classement actuel de la J2 League pour la saison 2023.	Demande de classement
Je souhaite connaître le classement complet de la Major League Soccer pour la saison 2022.	Demande de classement
Quelle est la position actuelle de mon équipe préférée dans la Allsvenskan suédoise pour la saison 2022.	Demande de classement
Donnez-moi le classement de la Eliteserien norvégienne pour la saison 2023.	Demande de classement
Quels sont les meilleurs clubs de la Liga MX pour la saison 2022-2023.	Demande de classement
Indiquez-moi le classement actualisé de la K League 1 pour la saison 2022.	Demande de classement
Pouvez-vous me fournir le classement détaillé de la LigaPro en Équateur pour la saison 2022-2023.	Demande de classement
Quels sont les leaders du championnat dans la Superliga argentine pour la saison 2023.	Demande de classement
Montrez-moi le classement actuel de la Premier Division irlandaise pour la saison 2022.	Demande de classement
Je souhaite connaître le classement complet de la Russian Premier League pour la saison 2022-2023.	Demande de classement
Quelle est la position actuelle de mon équipe préférée dans la LigaPro en Portugal pour la saison 2022-2023.	Demande de classement
Donnez-moi le classement de la Premier Soccer League sud-africaine pour la saison 2022-2023.	Demande de classement
Quels sont les meilleurs clubs de la A-League australienne pour la saison 2023.	Demande de classement
Indiquez-moi le classement actualisé de la Superliga danoise pour la saison 2022-2023.	Demande de classement
Pouvez-vous me fournir le classement détaillé de la J2 League pour la saison 2023.	Demande de classement
Quels sont les leaders du championnat dans la Major League Soccer pour la saison 2022.	Demande de classement
Montrez-moi le classement actuel de la Allsvenskan suédoise pour la saison 2022.	Demande de classement
Je souhaite connaître le classement complet de la Eliteserien norvégienne pour la saison 2023.	Demande de classement
Quelle est la position actuelle de mon équipe préférée dans la Liga MX pour la saison 2022-2023.	Demande de classement
Donnez-moi le classement de la K League 1 pour la saison 2022.	Demande de classement
Quels sont les meilleurs clubs de la LigaPro en Équateur pour la saison 2022-2023.	Demande de classement
Indiquez-moi le classement actualisé de la Superliga argentine pour la saison 2023.	Demande de classement
Pouvez-vous me fournir le classement détaillé de la Premier Division irlandaise pour la saison 2022.	Demande de classement
Quels sont les leaders du championnat dans la Russian Premier League pour la saison 2022-2023.	Demande de classement
Montrez-moi le classement actuel de la LigaPro en Portugal pour la saison 2022-2023.	Demande de classement
Je souhaite connaître le classement complet de la Premier Soccer League sud-africaine pour la saison 2022-2023.	Demande de classement
Quelle est la position actuelle de mon équipe préférée dans la A-League australienne pour la saison 2023.	Demande de classement
Donnez-moi le classement de la Superliga danoise pour la saison 2022-2023.	Demande de classement
Quels sont les meilleurs clubs de la J2 League pour la saison 2023.	Demande de classement
Indiquez-moi le classement actualisé de la Major League Soccer pour la saison 2022.	Demande de classement
Pouvez-vous me fournir le classement détaillé de la Allsvenskan suédoise pour la saison 2022.	Demande de classement
Quels sont les leaders du championnat dans la Eliteserien norvégienne pour la saison 2023.	Demande de classement
Montrez-moi le classement actuel de la Liga MX pour la saison 2022-2023.	Demande de classement
Je souhaite connaître le classement complet de la K League 1 pour la saison 2022.	Demande de classement
Quelle est la position actuelle de mon équipe préférée dans la LigaPro en Équateur pour la saison 2022-2023.	Demande de classement
Donnez-moi le classement de la Superliga argentine pour la saison 2023.	Demande de classement
Quels sont les meilleurs clubs de la Premier Division irlandaise pour la saison 2022.	Demande de classement
Indiquez-moi le classement actualisé de la Russian Premier League pour la saison 2022-2023.	Demande de classement
Pouvez-vous me fournir le classement détaillé de la LigaPro en Portugal pour la saison 2022-2023.	Demande de classement
Quels sont les leaders du championnat dans la Premier Soccer League sud-africaine pour la saison 2022-2023.	Demande de classement
Montrez-moi le classement actuel de la A-League australienne pour la saison 2023.	Demande de classement
Je souhaite connaître le classement complet de la Superliga danoise pour la saison 2022-2023.	Demande de classement
Quelle est la position actuelle de mon équipe préférée dans la J2 League pour la saison 2023.	Demande de classement
Donnez-moi le classement de la Major League Soccer pour la saison 2022.	Demande de classement
Quels sont les meilleurs clubs de la Allsvenskan suédoise pour la saison 2022.	Demande de classement
Indiquez-moi le classement actualisé de la Eliteserien norvégienne pour la saison 2023.	Demande de classement
Pouvez-vous me fournir le classement détaillé de la Liga MX pour la saison 2022-2023.	Demande de classement
Quels sont les leaders du championnat dans la K League 1 pour la saison 2022.	Demande de classement
Montrez-moi le classement actuel de la LigaPro en Équateur pour la saison 2022-2023.	Demande de classement
Je souhaite connaître le classement complet de la Superliga argentine pour la saison 2023.	Demande de classement
Quelle est la position actuelle de mon équipe préférée dans la Premier Division irlandaise pour la saison 2022.	Demande de classement
Donnez-moi le classement de la Russian Premier League pour la saison 2022-2023.	Demande de classement
Quels sont les meilleurs clubs de la LigaPro en Portugal pour la saison 2022-2023.	Demande de classement
Indiquez-moi le classement actualisé de la Premier Soccer League sud-africaine pour la saison 2022-2023.	Demande de classement
Pouvez-vous me fournir le classement détaillé de la A-League australienne pour la saison 2023.	Demande de classement
Quels sont les leaders du championnat dans la Superliga danoise pour la saison 2022-2023.	Demande de classement
Montrez-moi le classement actuel de la J2 League pour la saison 2023.	Demande de classement
Je souhaite connaître le classement complet de la Major League Soccer pour la saison 2022.	Demande de classement
Quelle est la position actuelle de mon équipe préférée dans la Allsvenskan suédoise pour la saison 2022.	Demande de classement
Donnez-moi le classement de la Eliteserien norvégienne pour la saison 2023.	Demande de classement
Quels sont les meilleurs clubs de la Liga MX pour la saison 2022-2023.	Demande de classement
Indiquez-moi le classement actualisé de la K League 1 pour la saison 2022.	Demande de classement
Pouvez-vous me fournir le classement détaillé de la LigaPro en Équateur pour la saison 2022-2023.	Demande de classement
Quels sont les leaders du championnat dans la Superliga argentine pour la saison 2023.	Demande de classement
Montrez-moi le classement actuel de la Premier Division irlandaise pour la saison 2022.	Demande de classement
Je souhaite connaître le classement complet de la Russian Premier League pour la saison 2022-2023.	Demande de classement
Quelle est la position actuelle de mon équipe préférée dans la LigaPro en Portugal pour la saison 2022-2023.	Demande de classement
Donnez-moi le classement de la Premier Soccer League sud-africaine pour la saison 2022-2023.	Demande de classement
Quels sont les meilleurs clubs de la A-League australienne pour la saison 2023.	Demande de classement
Indiquez-moi le classement actualisé de la Superliga danoise pour la saison 2022-2023.	Demande de classement
Pouvez-vous me fournir le classement détaillé de la J2 League pour la saison 2023.	Demande de classement
Quels sont les leaders du championnat dans la Major League Soccer pour la saison 2022.	Demande de classement
Quels sont tous les clubs que José Mourinho a entraînés ?	Obtenir des informations  d'entraîneur
Quelles sont les équipes précédentes de Pep Guardiola en tant qu'entraîneur ?	Obtenir des informations  d'entraîneur
Quels clubs ont bénéficié des services de Jurgen Klopp en tant qu'entraîneur ?	Obtenir des informations  d'entraîneur
Quelles sont les équipes que Antonio Conte a dirigées tout au long de sa carrière d'entraîneur ?	Obtenir des informations  d'entraîneur
Quels sont tous les clubs de football auxquels Zinedine Zidane a été associé en tant qu'entraîneur ?	Obtenir des informations  d'entraîneur
Quelles équipes ont eu Diego Simeone comme entraîneur principal ?	Obtenir des informations  d'entraîneur
Quels sont les clubs pour lesquels Carlo Ancelotti a travaillé en tant qu'entraîneur ?	Obtenir des informations  d'entraîneur
Quels sont tous les clubs où Mauricio Pochettino a exercé ses fonctions d'entraîneur ?	Obtenir des informations  d'entraîneur
Quelles sont les équipes qui ont eu Ernesto Valverde comme entraîneur ?	Obtenir des informations  d'entraîneur
Quels clubs ont eu Massimiliano Allegri à leur tête en tant qu'entraîneur ?	Obtenir des informations  d'entraîneur
Quels sont tous les clubs que Arsène Wenger a entraînés ?	Obtenir des informations  d'entraîneur
Quelles sont les équipes précédentes de Roberto Mancini en tant qu'entraîneur ?	Obtenir des informations  d'entraîneur
Quels clubs ont bénéficié des services de Jürgen Klinsmann en tant qu'entraîneur ?	Obtenir des informations  d'entraîneur
Quelles sont les équipes que Thomas Tuchel a dirigées tout au long de sa carrière d'entraîneur ?	Obtenir des informations  d'entraîneur
Quels sont tous les clubs de football auxquels Rafael Benítez a été associé en tant qu'entraîneur ?	Obtenir des informations  d'entraîneur
Quelles équipes ont eu Maurizio Sarri comme entraîneur principal ?	Obtenir des informations  d'entraîneur
Quels sont les clubs pour lesquels Marcelo Bielsa a travaillé en tant qu'entraîneur ?	Obtenir des informations  d'entraîneur
Quels sont tous les clubs où Lucien Favre a exercé ses fonctions d'entraîneur ?	Obtenir des informations  d'entraîneur
Quelles sont les équipes qui ont eu Laurent Blanc comme entraîneur ?	Obtenir des informations  d'entraîneur
Quels clubs ont eu Ronald Koeman à leur tête en tant qu'entraîneur ?	Obtenir des informations  d'entraîneur
Quels sont tous les clubs que Roberto Di Matteo a entraînés ?	Obtenir des informations  d'entraîneur
Quelles sont les équipes précédentes de Brendan Rodgers en tant qu'entraîneur ?	Obtenir des informations  d'entraîneur
Quels clubs ont bénéficié des services de Unai Emery en tant qu'entraîneur ?	Obtenir des informations  d'entraîneur
Quelles sont les équipes que Frank Lampard a dirigées tout au long de sa carrière d'entraîneur ?	Obtenir des informations  d'entraîneur
Quels sont tous les clubs de football auxquels Mauricio Pochettino a été associé en tant qu'entraîneur ?	Obtenir des informations  d'entraîneur
Quelles équipes ont eu Marcelo Bielsa comme entraîneur principal ?	Obtenir des informations  d'entraîneur
Quels sont les clubs pour lesquels André Villas-Boas a travaillé en tant qu'entraîneur ?	Obtenir des informations  d'entraîneur
Quels sont tous les clubs où Marco Silva a exercé ses fonctions d'entraîneur ?	Obtenir des informations  d'entraîneur
Quelles sont les équipes qui ont eu Nuno Espírito Santo comme entraîneur ?	Obtenir des informations  d'entraîneur
Quels clubs ont eu Rudi Garcia à leur tête en tant qu'entraîneur ?	Obtenir des informations  d'entraîneur
Quels sont tous les clubs que Diego Simeone a entraînés ?	Obtenir des informations  d'entraîneur
Quelles sont les équipes précédentes de Pep Guardiola en tant qu'entraîneur ?	Obtenir des informations  d'entraîneur
Quels clubs ont bénéficié des services de Carlo Ancelotti en tant qu'entraîneur ?	Obtenir des informations  d'entraîneur
Quelles sont les équipes que Antonio Conte a dirigées tout au long de sa carrière d'entraîneur ?	Obtenir des informations  d'entraîneur
Quels sont tous les clubs de football auxquels Maurizio Sarri a été associé en tant qu'entraîneur ?	Obtenir des informations  d'entraîneur
Quelles équipes ont eu Thomas Tuchel comme entraîneur principal ?	Obtenir des informations  d'entraîneur
Quels sont les clubs pour lesquels Julian Nagelsmann a travaillé en tant qu'entraîneur ?	Obtenir des informations  d'entraîneur
Quels sont tous les clubs où Erik ten Hag a exercé ses fonctions d'entraîneur ?	Obtenir des informations  d'entraîneur
Quelles sont les équipes qui ont eu Marco Rose comme entraîneur ?	Obtenir des informations  d'entraîneur
Quels clubs ont eu Simone Inzaghi à leur tête en tant qu'entraîneur ?	Obtenir des informations  d'entraîneur
Quels sont tous les clubs que Zinedine Zidane a entraînés ?	Obtenir des informations  d'entraîneur
Quelles sont les équipes précédentes de Jürgen Klopp en tant qu'entraîneur ?	Obtenir des informations  d'entraîneur
Quels clubs ont bénéficié des services de Diego Simeone en tant qu'entraîneur ?	Obtenir des informations  d'entraîneur
Quelles sont les équipes que Pep Guardiola a dirigées tout au long de sa carrière d'entraîneur ?	Obtenir des informations  d'entraîneur
Quels sont tous les clubs de football auxquels José Mourinho a été associé en tant qu'entraîneur ?	Obtenir des informations  d'entraîneur
Quelles équipes ont eu Unai Emery comme entraîneur principal ?	Obtenir des informations  d'entraîneur
Quels sont les clubs pour lesquels Lucien Favre a travaillé en tant qu'entraîneur ?	Obtenir des informations  d'entraîneur
Quels sont tous les clubs où Nuno Espírito Santo a exercé ses fonctions d'entraîneur ?	Obtenir des informations  d'entraîneur
Quelles sont les équipes qui ont eu Ernesto Valverde comme entraîneur ?	Obtenir des informations  d'entraîneur
Quels clubs ont eu Brendan Rodgers à leur tête en tant qu'entraîneur ?	Obtenir des informations  d'entraîneur
Quels sont tous les clubs que Antonio Conte a entraînés ?	Obtenir des informations  d'entraîneur
Quelles sont les équipes précédentes de Mauricio Pochettino en tant qu'entraîneur ?	Obtenir des informations  d'entraîneur
Quels clubs ont bénéficié des services de Roberto Di Matteo en tant qu'entraîneur ?	Obtenir des informations  d'entraîneur
Quelles sont les équipes que Rafael Benítez a dirigées tout au long de sa carrière d'entraîneur ?	Obtenir des informations  d'entraîneur
Quels sont tous les clubs de football auxquels Carlo Ancelotti a été associé en tant qu'entraîneur ?	Obtenir des informations  d'entraîneur
Quelles équipes ont eu Frank Lampard comme entraîneur principal ?	Obtenir des informations  d'entraîneur
Quels sont les clubs pour lesquels Marco Silva a travaillé en tant qu'entraîneur ?	Obtenir des informations  d'entraîneur
Quels sont tous les clubs où André Villas-Boas a exercé ses fonctions d'entraîneur ?	Obtenir des informations  d'entraîneur
Quelles sont les équipes qui ont eu Rudi Garcia comme entraîneur ?	Obtenir des informations  d'entraîneur
Quels clubs ont eu Unai Emery à leur tête en tant qu'entraîneur ?	Obtenir des informations  d'entraîneur
Quels sont tous les clubs que Maurizio Sarri a entraînés ?	Obtenir des informations  d'entraîneur
Quelles sont les équipes précédentes de Marcelo Bielsa en tant qu'entraîneur ?	Obtenir des informations  d'entraîneur
Quels clubs ont bénéficié des services de Thomas Tuchel en tant qu'entraîneur ?	Obtenir des informations  d'entraîneur
Quelles sont les équipes que Julian Nagelsmann a dirigées tout au long de sa carrière d'entraîneur ?	Obtenir des informations  d'entraîneur
Quels sont tous les clubs de football auxquels Mauricio Pochettino a été associé en tant qu'entraîneur ?	Obtenir des informations  d'entraîneur
Quelles équipes ont eu Erik ten Hag comme entraîneur principal ?	Obtenir des informations  d'entraîneur
Quels sont les clubs pour lesquels Marco Rose a travaillé en tant qu'entraîneur ?	Obtenir des informations  d'entraîneur
Quels sont tous les clubs où Simone Inzaghi a exercé ses fonctions d'entraîneur ?	Obtenir des informations  d'entraîneur
Quelles sont les équipes qui ont eu Lucien Favre comme entraîneur ?	Obtenir des informations  d'entraîneur
Quels clubs ont eu Julian Nagelsmann à leur tête en tant qu'entraîneur ?	Obtenir des informations  d'entraîneur
Quels sont tous les clubs que Diego Simeone a entraînés ?	Obtenir des informations  d'entraîneur
Quelles sont les équipes précédentes de Zinedine Zidane en tant qu'entraîneur ?	Obtenir des informations  d'entraîneur
Quels clubs ont bénéficié des services de Jürgen Klopp en tant qu'entraîneur ?	Obtenir des informations  d'entraîneur
Quelles sont les équipes que Pep Guardiola a dirigées tout au long de sa carrière d'entraîneur ?	Obtenir des informations  d'entraîneur
Quels sont tous les clubs de football auxquels Antonio Conte a été associé en tant qu'entraîneur ?	Obtenir des informations  d'entraîneur
Quelles équipes ont eu Mauricio Pochettino comme entraîneur principal ?	Obtenir des informations  d'entraîneur
Quels sont les clubs pour lesquels Ernesto Valverde a travaillé en tant qu'entraîneur ?	Obtenir des informations  d'entraîneur
Quels sont tous les clubs où Brendan Rodgers a exercé ses fonctions d'entraîneur ?	Obtenir des informations  d'entraîneur
Quelles sont les équipes qui ont eu Nuno Espírito Santo comme entraîneur ?	Obtenir des informations  d'entraîneur
Quels clubs ont eu Maurizio Sarri à leur tête en tant qu'entraîneur ?	Obtenir des informations  d'entraîneur
Quels sont tous les clubs que Roberto Mancini a entraînés ?	Obtenir des informations  d'entraîneur
Quelles sont les équipes précédentes de Unai Emery en tant qu'entraîneur ?	Obtenir des informations  d'entraîneur
Quels clubs ont bénéficié des services de Rudi Garcia en tant qu'entraîneur ?	Obtenir des informations  d'entraîneur
Quelles sont les équipes que Simone Inzaghi a dirigées tout au long de sa carrière d'entraîneur ?	Obtenir des informations  d'entraîneur
Quels sont tous les clubs de football auxquels Lucien Favre a été associé en tant qu'entraîneur ?	Obtenir des informations  d'entraîneur
Quelles équipes ont eu Marco Silva comme entraîneur principal ?	Obtenir des informations  d'entraîneur
Quels sont les clubs pour lesquels Erik ten Hag a travaillé en tant qu'entraîneur ?	Obtenir des informations  d'entraîneur
Quels sont tous les clubs où Roberto Di Matteo a exercé ses fonctions d'entraîneur ?	Obtenir des informations  d'entraîneur
Quelles sont les équipes qui ont eu Julian Nagelsmann comme entraîneur ?	Obtenir des informations  d'entraîneur
Quels clubs ont eu Carlo Ancelotti à leur tête en tant qu'entraîneur ?	Obtenir des informations  d'entraîneur
Quels sont tous les clubs que Mauricio Pochettino a entraînés ?	Obtenir des informations  d'entraîneur
Quelles sont les équipes précédentes de Thomas Tuchel en tant qu'entraîneur ?	Obtenir des informations  d'entraîneur
Quels clubs ont bénéficié des services de Marco Silva en tant qu'entraîneur ?	Obtenir des informations  d'entraîneur
Quelles sont les équipes que Erik ten Hag a dirigées tout au long de sa carrière d'entraîneur ?	Obtenir des informations  d'entraîneur
Quels sont tous les clubs de football auxquels Julian Nagelsmann a été associé en tant qu'entraîneur ?	Obtenir des informations  d'entraîneur
Quelles équipes ont eu Rudi Garcia comme entraîneur principal ?	Obtenir des informations  d'entraîneur
Quels sont les clubs pour lesquels Unai Emery a travaillé en tant qu'entraîneur ?	Obtenir des informations  d'entraîneur
Quels sont tous les clubs où Maurizio Sarri a exercé ses fonctions d'entraîneur ?	Obtenir des informations  d'entraîneur
Quelles sont les équipes qui ont eu Simone Inzaghi comme entraîneur ?	Obtenir des informations  d'entraîneur
Quels clubs ont eu Nuno Espírito Santo à leur tête en tant qu'entraîneur ?	Obtenir des informations  d'entraîneur
Quels sont tous les clubs que Jürgen Klopp a entraînés ?	Obtenir des informations  d'entraîneur
Quelles sont les équipes précédentes de Diego Simeone en tant qu'entraîneur ?	Obtenir des informations  d'entraîneur
Quels clubs ont bénéficié des services de Zinedine Zidane en tant qu'entraîneur ?	Obtenir des informations  d'entraîneur
Quelles sont les équipes que José Mourinho a dirigées tout au long de sa carrière d'entraîneur ?	Obtenir des informations  d'entraîneur
Quels sont tous les clubs de football auxquels Pep Guardiola a été associé en tant qu'entraîneur ?	Obtenir des informations  d'entraîneur
Quelles équipes ont eu Antonio Conte comme entraîneur principal ?	Obtenir des informations  d'entraîneur
Quels sont les clubs pour lesquels Carlo Ancelotti a travaillé en tant qu'entraîneur ?	Obtenir des informations  d'entraîneur
Quels sont tous les clubs où Mauricio Pochettino a exercé ses fonctions d'entraîneur ?	Obtenir des informations  d'entraîneur
Quelles sont les équipes qui ont eu Thomas Tuchel comme entraîneur ?	Obtenir des informations  d'entraîneur
Quels clubs ont eu Julian Nagelsmann à leur tête en tant qu'entraîneur ?	Obtenir des informations  d'entraîneur
Quels sont tous les clubs que Marcelo Bielsa a entraînés ?	Obtenir des informations  d'entraîneur
Quelles sont les équipes précédentes de Lucien Favre en tant qu'entraîneur ?	Obtenir des informations  d'entraîneur
Quels clubs ont bénéficié des services de Marco Rose en tant qu'entraîneur ?	Obtenir des informations  d'entraîneur
Quelles sont les équipes que Erik ten Hag a dirigées tout au long de sa carrière d'entraîneur ?	Obtenir des informations  d'entraîneur
Quels sont tous les clubs de football auxquels Unai Emery a été associé en tant qu'entraîneur ?	Obtenir des informations  d'entraîneur
Quelles équipes ont eu Nuno Espírito Santo comme entraîneur principal ?	Obtenir des informations  d'entraîneur
Quels sont les clubs pour lesquels Maurizio Sarri a travaillé en tant qu'entraîneur ?	Obtenir des informations  d'entraîneur
Quels sont tous les clubs où Simone Inzaghi a exercé ses fonctions d'entraîneur ?	Obtenir des informations  d'entraîneur
Quelles sont les équipes qui ont eu Rudi Garcia comme entraîneur ?	Obtenir des informations  d'entraîneur
Quels clubs ont eu Lucien Favre à leur tête en tant qu'entraîneur ?	Obtenir des informations  d'entraîneur
Quel est le nom du stade de l'équipe du FC Barcelone ?	Demander le nom du stade d'une équipe 
Dans quel stade joue le Real Madrid ?	Demander le nom du stade d'une équipe 
Comment s'appelle le stade de l'équipe de Manchester United ?	Demander le nom du stade d'une équipe 
Quel est le stade domicile du Paris Saint-Germain ?	Demander le nom du stade d'une équipe 
Où se déroulent les matchs de l'équipe de la Juventus ?	Demander le nom du stade d'une équipe 
Quel est le nom du stade de l'Atlético de Madrid ?	Demander le nom du stade d'une équipe 
Dans quel stade joue l'équipe de Chelsea ?	Demander le nom du stade d'une équipe 
Comment s'appelle le stade du Bayern Munich ?	Demander le nom du stade d'une équipe 
Quel est le stade domicile de l'équipe de l'AS Roma ?	Demander le nom du stade d'une équipe 
Où se déroulent les matchs de l'équipe du Borussia Dortmund ?	Demander le nom du stade d'une équipe 
Quel est le nom du stade de l'équipe de Liverpool ?	Demander le nom du stade d'une équipe 
Dans quel stade joue le FC Barcelone ?	Demander le nom du stade d'une équipe 
Comment s'appelle le stade de l'équipe du Real Madrid ?	Demander le nom du stade d'une équipe 
Quel est le stade domicile du Manchester City ?	Demander le nom du stade d'une équipe 
Où se déroulent les matchs de l'équipe de l'Inter Milan ?	Demander le nom du stade d'une équipe 
Quel est le nom du stade de l'AC Milan ?	Demander le nom du stade d'une équipe 
Dans quel stade joue l'équipe de l'Ajax Amsterdam ?	Demander le nom du stade d'une équipe 
Comment s'appelle le stade du Paris Saint-Germain ?	Demander le nom du stade d'une équipe 
Quel est le stade domicile de l'équipe de Tottenham Hotspur ?	Demander le nom du stade d'une équipe 
Où se déroulent les matchs de l'équipe du FC Porto ?	Demander le nom du stade d'une équipe 
Quel est le nom du stade de l'équipe de l'Olympique de Marseille ?	Demander le nom du stade d'une équipe 
Dans quel stade joue le Benfica Lisbonne ?	Demander le nom du stade d'une équipe 
Comment s'appelle le stade de l'équipe du Borussia Mönchengladbach ?	Demander le nom du stade d'une équipe 
Quel est le stade domicile de l'équipe de l'AS Monaco ?	Demander le nom du stade d'une équipe 
Où se déroulent les matchs de l'équipe de l'Atalanta Bergame ?	Demander le nom du stade d'une équipe 
Quel est le nom du stade de l'équipe de l'ACF Fiorentina ?	Demander le nom du stade d'une équipe 
Dans quel stade joue l'équipe de Séville FC ?	Demander le nom du stade d'une équipe 
Comment s'appelle le stade du FC Séville ?	Demander le nom du stade d'une équipe 
Quel est le stade domicile de l'équipe de l'Olympique Lyonnais ?	Demander le nom du stade d'une équipe 
Où se déroulent les matchs de l'équipe de Schalke 04 ?	Demander le nom du stade d'une équipe 
Quel est le nom du stade de l'équipe de l'AS Saint-Étienne ?	Demander le nom du stade d'une équipe 
Dans quel stade joue le FC Valence ?	Demander le nom du stade d'une équipe 
Comment s'appelle le stade de l'équipe du Celtic Glasgow ?	Demander le nom du stade d'une équipe 
Quel est le stade domicile de l'équipe de l'OGC Nice ?	Demander le nom du stade d'une équipe 
Où se déroulent les matchs de l'équipe de l'Eintracht Francfort ?	Demander le nom du stade d'une équipe 
Quel est le nom du stade de l'équipe de West Ham United ?	Demander le nom du stade d'une équipe 
Dans quel stade joue l'équipe du FC Porto ?	Demander le nom du stade d'une équipe 
Comment s'appelle le stade de l'équipe du FC Séville ?	Demander le nom du stade d'une équipe 
Quel est le stade domicile de l'équipe de l'AS Monaco ?	Demander le nom du stade d'une équipe 
Où se déroulent les matchs de l'équipe de l'Atalanta Bergame ?	Demander le nom du stade d'une équipe 
Quel est le nom du stade de l'équipe de l'ACF Fiorentina ?	Demander le nom du stade d'une équipe 
Dans quel stade joue l'équipe de Séville FC ?	Demander le nom du stade d'une équipe 
Comment s'appelle le stade du FC Séville ?	Demander le nom du stade d'une équipe 
Quel est le stade domicile de l'équipe de l'Olympique Lyonnais ?	Demander le nom du stade d'une équipe 
Où se déroulent les matchs de l'équipe de Schalke 04 ?	Demander le nom du stade d'une équipe 
Quel est le nom du stade de l'équipe de l'AS Saint-Étienne ?	Demander le nom du stade d'une équipe 
Dans quel stade joue le FC Valence ?	Demander le nom du stade d'une équipe 
Comment s'appelle le stade de l'équipe du Celtic Glasgow ?	Demander le nom du stade d'une équipe 
Quel est le stade domicile de l'équipe de l'OGC Nice ?	Demander le nom du stade d'une équipe 
Où se déroulent les matchs de l'équipe de l'Eintracht Francfort ?	Demander le nom du stade d'une équipe 
Qui était le meilleur buteur de La Liga pour la saison 2008 ?	meilleur buteur
Quel joueur a marqué le plus de buts dans La Liga en 2008 ?	meilleur buteur
Qui a terminé en tête du classement des buteurs de La Liga en 2008 ?	meilleur buteur
Quel est le nom du joueur qui a marqué le plus de buts dans La Liga cette année-là ?	meilleur buteur
Pouvez-vous me donner des informations sur le meilleur buteur de La Liga en 2008 ?	meilleur buteur
Qui occupait la première place du classement des buteurs de La Liga pour cette saison ?	meilleur buteur
Quel joueur a terminé en tête du classement des buteurs de La Liga en 2008 et combien de buts a-t-il marqués ?	meilleur buteur
Quel est le classement des buteurs de La Liga pour la saison 2008 et qui était en tête ?	meilleur buteur
Qui était le principal buteur de La Liga en 2008 ?	meilleur buteur
Pouvez-vous me dire qui était le meilleur buteur de La Liga en 2008 et combien de buts il a marqués ?	meilleur buteur
Qui était le meilleur buteur de La Liga pour la saison 2009 ?	meilleur buteur
Quel joueur a marqué le plus de buts dans La Liga en 2010 ?	meilleur buteur
Qui a terminé en tête du classement des buteurs de La Liga en 2011 ?	meilleur buteur
Quel est le nom du joueur qui a marqué le plus de buts dans La Liga en 2012 ?	meilleur buteur
Qui était le meilleur buteur de La Liga pour la saison 2013 ?	meilleur buteur
Quel joueur a marqué le plus de buts dans La Liga en 2014 ?	meilleur buteur
Qui a terminé en tête du classement des buteurs de La Liga en 2015 ?	meilleur buteur
Quel est le nom du joueur qui a marqué le plus de buts dans La Liga en 2016 ?	meilleur buteur
Qui était le meilleur buteur de La Liga pour la saison 2017 ?	meilleur buteur
Quel joueur a marqué le plus de buts dans La Liga en 2018 ?	meilleur buteur
Qui a terminé en tête du classement des buteurs de La Liga en 2019 ?	meilleur buteur
Quel est le nom du joueur qui a marqué le plus de buts dans La Liga en 2020 ?	meilleur buteur
Qui était le meilleur buteur de La Liga pour la saison 2021 ?	meilleur buteur
Quel joueur a marqué le plus de buts dans La Liga en 2022 ?	meilleur buteur
Qui a terminé en tête du classement des buteurs de La Liga en 2023 ?	meilleur buteur
Qui était le meilleur buteur de La Liga pour la saison 2009 ?	meilleur buteur
Quel joueur a marqué le plus de buts dans La Liga en 2009 ?	meilleur buteur
Qui a terminé en tête du classement des buteurs de La Liga en 2009 ?	meilleur buteur
Quel est le nom du joueur qui a marqué le plus de buts dans La Liga en 2009 ?	meilleur buteur
Qui était le meilleur buteur de La Liga pour la saison 2010 ?	meilleur buteur
Quel joueur a marqué le plus de buts dans La Liga en 2010 ?	meilleur buteur
Qui a terminé en tête du classement des buteurs de La Liga en 2010 ?	meilleur buteur
Quel est le nom du joueur qui a marqué le plus de buts dans La Liga en 2010 ?	meilleur buteur
Qui était le meilleur buteur de La Liga pour la saison 2011 ?	meilleur buteur
Quel joueur a marqué le plus de buts dans La Liga en 2011 ?	meilleur buteur
Qui a terminé en tête du classement des buteurs de La Liga en 2011 ?	meilleur buteur
Quel est le nom du joueur qui a marqué le plus de buts dans La Liga en 2011 ?	meilleur buteur
Qui était le meilleur buteur de La Liga pour la saison 2012 ?	meilleur buteur
Quel joueur a marqué le plus de buts dans La Liga en 2012 ?	meilleur buteur
Qui a terminé en tête du classement des buteurs de La Liga en 2012 ?	meilleur buteur
Quel est le nom du joueur qui a marqué le plus de buts dans La Liga en 2012 ?	meilleur buteur
Qui était le meilleur buteur de La Liga pour la saison 2013 ?	meilleur buteur
Quel joueur a marqué le plus de buts dans La Liga en 2013 ?	meilleur buteur
Qui a terminé en tête du classement des buteurs de La Liga en 2013 ?	meilleur buteur
Quel est le nom du joueur qui a marqué le plus de buts dans La Liga en 2013 ?	meilleur buteur
Qui était le meilleur buteur de La Liga pour la saison 2014 ?	meilleur buteur
Quel joueur a marqué le plus de buts dans La Liga en 2014 ?	meilleur buteur
Qui a terminé en tête du classement des buteurs de La Liga en 2014 ?	meilleur buteur
Quel est le nom du joueur qui a marqué le plus de buts dans La Liga en 2014 ?	meilleur buteur
Qui était le meilleur buteur de La Liga pour la saison 2015 ?	meilleur buteur
Quel joueur a marqué le plus de buts dans La Liga en 2015 ?	meilleur buteur
Qui a terminé en tête du classement des buteurs de La Liga en 2015 ?	meilleur buteur
Quel est le nom du joueur qui a marqué le plus de buts dans La Liga en 2015 ?	meilleur buteur
Qui était le meilleur buteur de La Liga pour la saison 2016 ?	meilleur buteur
Quel joueur a marqué le plus de buts dans La Liga en 2016 ?	meilleur buteur
Qui a terminé en tête du classement des buteurs de La Liga en 2016 ?	meilleur buteur
Quel est le nom du joueur qui a marqué le plus de buts dans La Liga en 2016 ?	meilleur buteur
Qui était le meilleur buteur de La Liga pour la saison 2017 ?	meilleur buteur
Quel joueur a marqué le plus de buts dans La Liga en 2017 ?	meilleur buteur
Qui a terminé en tête du classement des buteurs de La Liga en 2017 ?	meilleur buteur
Quel est le nom du joueur qui a marqué le plus de buts dans La Liga en 2017 ?	meilleur buteur
Qui était le meilleur buteur de La Liga pour la saison 2018 ?	meilleur buteur
Quel joueur a marqué le plus de buts dans La Liga en 2018 ?	meilleur buteur
Qui a terminé en tête du classement des buteurs de La Liga en 2018 ?	meilleur buteur
Quel est le nom du joueur qui a marqué le plus de buts dans La Liga en 2018 ?	meilleur buteur
Qui était le meilleur buteur de La Liga pour la saison 2019 ?	meilleur buteur
Quel joueur a marqué le plus de buts dans La Liga en 2019 ?	meilleur buteur
Qui a terminé en tête du classement des buteurs de La Liga en 2019 ?	meilleur buteur
Quel est le nom du joueur qui a marqué le plus de buts dans La Liga en 2019 ?	meilleur buteur
Qui était le meilleur buteur de La Liga pour la saison 2020 ?	meilleur buteur
Quel joueur a marqué le plus de buts dans La Liga en 2020 ?	meilleur buteur
Qui a terminé en tête du classement des buteurs de La Liga en 2020 ?	meilleur buteur
Quel est le nom du joueur qui a marqué le plus de buts dans La Liga en 2020 ?	meilleur buteur
Qui était le meilleur buteur de La Liga pour la saison 2021 ?	meilleur buteur
Quel joueur a marqué le plus de buts dans La Liga en 2021 ?	meilleur buteur
Qui a terminé en tête du classement des buteurs de La Liga en 2021 ?	meilleur buteur
Quel est le nom du joueur qui a marqué le plus de buts dans La Liga en 2021 ?	meilleur buteur
Qui était le meilleur buteur de La Liga pour la saison 2022 ?	meilleur buteur
Quel joueur a marqué le plus de buts dans La Liga en 2022 ?	meilleur buteur
Qui a terminé en tête du classement des buteurs de La Liga en 2022 ?	meilleur buteur
Quel est le nom du joueur qui a marqué le plus de buts dans La Liga en 2022 ?	meilleur buteur
Qui était le meilleur buteur de La Liga pour la saison 2023 ?	meilleur buteur
Quel joueur a marqué le plus de buts dans La Liga en 2023 ?	meilleur buteur
Qui a terminé en tête du classement des buteurs de La Liga en 2023 ?	meilleur buteur
Quel est le nom du joueur qui a marqué le plus de buts dans La Liga en 2023 ?	meilleur buteur
Qui était le meilleur buteur de la Premier League pour la saison 2009 ?	meilleur buteur
Quel joueur a marqué le plus de buts en Bundesliga en 2010 ?	meilleur buteur
Qui a terminé en tête du classement des buteurs de la Serie A en 2011 ?	meilleur buteur
Quel est le nom du joueur qui a marqué le plus de buts en Ligue 1 en 2012 ?	meilleur buteur
Qui était le meilleur buteur de la Liga MX pour la saison 2013 ?	meilleur buteur
Quel joueur a marqué le plus de buts en Major League Soccer (MLS) en 2014 ?	meilleur buteur
Qui a terminé en tête du classement des buteurs de la Superliga argentine en 2015 ?	meilleur buteur
Quel est le nom du joueur qui a marqué le plus de buts en Eredivisie en 2016 ?	meilleur buteur
Qui était le meilleur buteur de la J-League pour la saison 2017 ?	meilleur buteur
Quel joueur a marqué le plus de buts en Primeira Liga en 2018 ?	meilleur buteur
Qui a terminé en tête du classement des buteurs de la Scottish Premiership en 2019 ?	meilleur buteur
Quel est le nom du joueur qui a marqué le plus de buts en Chinese Super League en 2020 ?	meilleur buteur
Qui était le meilleur buteur de la Süper Lig pour la saison 2021 ?	meilleur buteur
Quel joueur a marqué le plus de buts en Serie A brésilienne en 2022 ?	meilleur buteur
Qui a terminé en tête du classement des buteurs de la Major League Soccer (MLS) en 2023 ?	meilleur buteur
Quel est le nom du joueur qui a marqué le plus de buts en Ligue 1 pour la saison 2009 ?	meilleur buteur
Qui était le meilleur buteur de la Bundesliga pour la saison 2010 ?	meilleur buteur
Quel joueur a marqué le plus de buts en Premier League en 2011 ?	meilleur buteur
Qui a terminé en tête du classement des buteurs de la Liga MX en 2012 ?	meilleur buteur
Quel est le nom du joueur qui a marqué le plus de buts en Serie A pour la saison 2013 ?	meilleur buteur
Qui était le meilleur buteur de la Major League Soccer (MLS) pour la saison 2014 ?	meilleur buteur
Quel joueur a marqué le plus de buts en Superliga argentine en 2015 ?	meilleur buteur
Qui a terminé en tête du classement des buteurs de l'Eredivisie en 2016 ?	meilleur buteur
Quel est le nom du joueur qui a marqué le plus de buts en J-League en 2017 ?	meilleur buteur
Qui était le meilleur buteur de la Primeira Liga pour la saison 2018 ?	meilleur buteur
Quel joueur a marqué le plus de buts en Scottish Premiership en 2019 ?	meilleur buteur
Qui a terminé en tête du classement des buteurs de la Chinese Super League en 2020 ?	meilleur buteur
Quel est le nom du joueur qui a marqué le plus de buts en Süper Lig pour la saison 2021 ?	meilleur buteur
Qui était le meilleur buteur de la Serie A brésilienne pour la saison 2022 ?	meilleur buteur
Quel joueur a marqué le plus de buts en Major League Soccer (MLS) en 2023 ?	meilleur buteur
Qui a terminé en tête du classement des buteurs de la Premier League pour la saison 2009 ?	meilleur buteur
Quel est le nom du joueur qui a marqué le plus de buts en Bundesliga en 2010 ?	meilleur buteur
Qui était le meilleur buteur de la Serie A pour la saison 2011 ?	meilleur buteur
Quel joueur a marqué le plus de buts en Ligue 1 en 2012 ?	meilleur buteur
Qui a terminé en tête du classement des buteurs de la Liga MX en 2013 ?	meilleur buteur
Quel est le nom du joueur qui a marqué le plus de buts en Major League Soccer (MLS) en 2014 ?	meilleur buteur
Qui était le meilleur buteur de la Superliga argentine pour la saison 2015 ?	meilleur buteur
Quel joueur a marqué le plus de buts en Eredivisie en 2016 ?	meilleur buteur
Qui a terminé en tête du classement des buteurs de la J-League en 2017 ?	meilleur buteur
Quel est le nom du joueur qui a marqué le plus de buts en Primeira Liga en 2018 ?	meilleur buteur
Qui était le meilleur buteur de la Scottish Premiership pour la saison 2019 ?	meilleur buteur
Quel joueur a marqué le plus de buts en Chinese Super League en 2020 ?	meilleur buteur
Qui a terminé en tête du classement des buteurs de la Süper Lig en 2021 ?	meilleur buteur
Quel est le nom du joueur qui a marqué le plus de buts en Serie A brésilienne en 2022 ?	meilleur buteur
Qui était le meilleur buteur de la Major League Soccer (MLS) pour la saison 2023 ?	meilleur buteur
Quel joueur a marqué le plus de buts en Ligue 1 pour la saison 2009 ?	meilleur buteur
Qui a terminé en tête du classement des buteurs de la Bundesliga en 2010 ?	meilleur buteur
Quel est le nom du joueur qui a marqué le plus de buts en Premier League en 2011 ?	meilleur buteur
Qui était le meilleur buteur de la Liga MX pour la saison 2012 ?	meilleur buteur
Quel joueur a marqué le plus de buts en Serie A pour la saison 2013 ?	meilleur buteur
Qui a terminé en tête du classement des buteurs de la Major League Soccer (MLS) en 2014 ?	meilleur buteur
Quel est le nom du joueur qui a marqué le plus de buts en Superliga argentine en 2015 ?	meilleur buteur
Qui était le meilleur buteur de l'Eredivisie pour la saison 2016 ?	meilleur buteur
Quel joueur a marqué le plus de buts en J-League en 2017 ?	meilleur buteur
Qui a terminé en tête du classement des buteurs de la Primeira Liga en 2018 ?	meilleur buteur
Quel est le nom du joueur qui a marqué le plus de buts en Scottish Premiership en 2019 ?	meilleur buteur
Qui était le meilleur buteur de la Chinese Super League pour la saison 2020 ?	meilleur buteur
Quel joueur a marqué le plus de buts en Süper Lig en 2021 ?	meilleur buteur
Qui a terminé en tête du classement des buteurs de la Serie A brésilienne en 2022 ?	meilleur buteur
Quel est le nom du joueur qui a marqué le plus de buts en Major League Soccer (MLS) en 2023 ?	meilleur buteur
Quels sont les joueurs de l'équipe Real Madrid ?	joueurs d'une equipe
Pouvez-vous me donner la liste des joueurs de l'équipe Manchester United ?	joueurs d'une equipe
Quels sont les membres de l'équipe Bayern Munich ?	joueurs d'une equipe
Qui joue pour l'équipe Barcelona ?	joueurs d'une equipe
Quelle est la composition de l'équipe Juventus ?	joueurs d'une equipe
Je souhaite connaître les noms des joueurs de l'équipe Paris Saint-Germain.	joueurs d'une equipe
Qui sont les joueurs qui représentent Liverpool ?	joueurs d'une equipe
Liste des joueurs de l'équipe Chelsea.	joueurs d'une equipe
Quels joueurs font partie de l'équipe Arsenal ?	joueurs d'une equipe
J'aimerais obtenir des informations sur les membres de l'équipe Manchester City	joueurs d'une equipe
Quels sont les joueurs de l'équipe Real Madrid ?	joueurs d'une equipe
Pouvez-vous me donner la liste des joueurs de l'équipe Manchester United ?	joueurs d'une equipe
Quels sont les membres de l'équipe Bayern Munich ?	joueurs d'une equipe
Qui joue pour l'équipe Barcelona ?	joueurs d'une equipe
Quelle est la composition de l'équipe Juventus ?	joueurs d'une equipe
Je souhaite connaître les noms des joueurs de l'équipe Paris Saint-Germain.	joueurs d'une equipe
Qui sont les joueurs qui représentent Liverpool ?	joueurs d'une equipe
Liste des joueurs de l'équipe Chelsea.	joueurs d'une equipe
Quels joueurs font partie de l'équipe Arsenal ?	joueurs d'une equipe
J'aimerais obtenir des informations sur les membres de l'équipe Manchester City.	joueurs d'une equipe
Quels sont les joueurs de l'équipe Borussia Dortmund ?	joueurs d'une equipe
Pouvez-vous me donner la liste des joueurs de l'équipe AC Milan ?	joueurs d'une equipe
Quels sont les membres de l'équipe Tottenham Hotspur ?	joueurs d'une equipe
Qui joue pour l'équipe Inter Milan ?	joueurs d'une equipe
Quelle est la composition de l'équipe Atletico Madrid ?	joueurs d'une equipe
Je souhaite connaître les noms des joueurs de l'équipe Bayern Munich.	joueurs d'une equipe
Qui sont les joueurs qui représentent Manchester United ?	joueurs d'une equipe
Liste des joueurs de l'équipe Arsenal.	joueurs d'une equipe
Quels joueurs font partie de l'équipe Chelsea ?	joueurs d'une equipe
J'aimerais obtenir des informations sur les membres de l'équipe Juventus.	joueurs d'une equipe
Quels sont les joueurs de l'équipe Paris Saint-Germain ?	joueurs d'une equipe
Pouvez-vous me donner la liste des joueurs de l'équipe Barcelona ?	joueurs d'une equipe
Quels sont les membres de l'équipe Real Madrid ?	joueurs d'une equipe
Qui joue pour l'équipe Liverpool ?	joueurs d'une equipe
Quelle est la composition de l'équipe Manchester City ?	joueurs d'une equipe
Je souhaite connaître les noms des joueurs de l'équipe Borussia Dortmund.	joueurs d'une equipe
Qui sont les joueurs qui représentent AC Milan ?	joueurs d'une equipe
Liste des joueurs de l'équipe Tottenham Hotspur.	joueurs d'une equipe
Quels joueurs font partie de l'équipe Inter Milan ?	joueurs d'une equipe
J'aimerais obtenir des informations sur les membres de l'équipe Atletico Madrid.	joueurs d'une equipe
Quels sont les joueurs de l'équipe Chelsea ?	joueurs d'une equipe
Pouvez-vous me donner la liste des joueurs de l'équipe Arsenal ?	joueurs d'une equipe
Quels sont les membres de l'équipe Manchester United ?	joueurs d'une equipe
Qui joue pour l'équipe Juventus ?	joueurs d'une equipe
Quelle est la composition de l'équipe Bayern Munich ?	joueurs d'une equipe
Je souhaite connaître les noms des joueurs de l'équipe Liverpool.	joueurs d'une equipe
Qui sont les joueurs qui représentent Paris Saint-Germain ?	joueurs d'une equipe
Liste des joueurs de l'équipe Barcelona.	joueurs d'une equipe
Quels joueurs font partie de l'équipe Real Madrid ?	joueurs d'une equipe
J'aimerais obtenir des informations sur les membres de l'équipe Manchester City.	joueurs d'une equipe
Quels sont les joueurs de l'équipe Tottenham Hotspur ?	joueurs d'une equipe
Pouvez-vous me donner la liste des joueurs de l'équipe Borussia Dortmund ?	joueurs d'une equipe
Quels sont les membres de l'équipe AC Milan ?	joueurs d'une equipe
Qui joue pour l'équipe Chelsea ?	joueurs d'une equipe
Quelle est la composition de l'équipe Arsenal ?	joueurs d'une equipe
Je souhaite connaître les noms des joueurs de l'équipe Inter Milan.	joueurs d'une equipe
Qui sont les joueurs qui représentent Atletico Madrid ?	joueurs d'une equipe
Liste des joueurs de l'équipe Manchester United.	joueurs d'une equipe
Quels joueurs font partie de l'équipe Barcelona ?	joueurs d'une equipe
J'aimerais obtenir des informations sur les membres de l'équipe Paris Saint-Germain.	joueurs d'une equipe
Quelle est l'équipe du joueur Lionel Messi ?	equipe d'une joueur
Dans quelle équipe joue Cristiano Ronaldo ?	equipe d'une joueur
Qui est l'équipe actuelle du joueur Neymar Jr. ?	equipe d'une joueur
Quelle équipe a recruté Kylian Mbappé ?	equipe d'une joueur
À quelle équipe appartient Mohamed Salah ?	equipe d'une joueur
Quelle est l'équipe professionnelle du joueur Kevin De Bruyne ?	equipe d'une joueur
Quelle équipe a signé Robert Lewandowski ?	equipe d'une joueur
Dans quel club évolue Harry Kane ?	equipe d'une joueur
Quelle équipe a transféré Sergio Ramos ?	equipe d'une joueur
Qui est le club actuel de Manuel Neuer ?	equipe d'une joueur
Dans quelle équipe joue Eden Hazard ?	equipe d'une joueur
Quelle est l'équipe du joueur Virgil van Dijk ?	equipe d'une joueur
À quelle équipe appartient Antoine Griezmann ?	equipe d'une joueur
Quelle équipe a recruté Erling Haaland ?	equipe d'une joueur
Qui est l'équipe actuelle du joueur Paul Pogba ?	equipe d'une joueur
Quelle équipe a signé Gareth Bale ?	equipe d'une joueur
Dans quel club évolue Karim Benzema ?	equipe d'une joueur
Quelle équipe a transféré Romelu Lukaku ?	equipe d'une joueur
Qui est le club actuel de Luka Modrić ?	equipe d'une joueur
Dans quelle équipe joue Mohamed Salah ?	equipe d'une joueur
Quelle est l'équipe du joueur Raheem Sterling ?	equipe d'une joueur
À quelle équipe appartient Harry Kane ?	equipe d'une joueur
Quelle équipe a recruté Sadio Mané ?	equipe d'une joueur
Qui est l'équipe actuelle du joueur Paulo Dybala ?	equipe d'une joueur
Quelle équipe a signé Bruno Fernandes ?	equipe d'une joueur
Dans quel club évolue Pierre-Emerick Aubameyang ?	equipe d'une joueur
Quelle équipe a transféré N'Golo Kanté ?	equipe d'une joueur
Qui est le club actuel de Marc-André ter Stegen ?	equipe d'une joueur
Dans quelle équipe joue Antoine Griezmann ?	equipe d'une joueur
Quelle est l'équipe du joueur Jadon Sancho ?	equipe d'une joueur
À quelle équipe appartient Robert Lewandowski ?	equipe d'une joueur
Quelle équipe a recruté Marcus Rashford ?	equipe d'une joueur
Qui est l'équipe actuelle du joueur Son Heung-min ?	equipe d'une joueur
Quelle équipe a signé Raheem Sterling ?	equipe d'une joueur
Dans quel club évolue Erling Haaland ?	equipe d'une joueur
Quelle équipe a transféré Cristiano Ronaldo ?	equipe d'une joueur
Qui est le club actuel de Bruno Fernandes ?	equipe d'une joueur
Dans quelle équipe joue Kylian Mbappé ?	equipe d'une joueur
Quelle est l'équipe du joueur Trent Alexander-Arnold ?	equipe d'une joueur
À quelle équipe appartient Virgil van Dijk ?	equipe d'une joueur
Quelle équipe a recruté Alisson Becker ?	equipe d'une joueur
Qui est l'équipe actuelle du joueur Joshua Kimmich ?	equipe d'une joueur
Quelle équipe a signé Romelu Lukaku ?	equipe d'une joueur
Dans quel club évolue João Félix ?	equipe d'une joueur
Quelle équipe a transféré Eden Hazard ?	equipe d'une joueur
Qui est le club actuel de Marco Verratti ?	equipe d'une joueur
Dans quelle équipe joue Luka Modrić ?	equipe d'une joueur
Quelle est l'équipe du joueur Serge Gnabry ?	equipe d'une joueur
À quelle équipe appartient Kevin De Bruyne ?	equipe d'une joueur
Quelle équipe a recruté Sergio Ramos ?	equipe d'une joueur
Qui est l'équipe actuelle du joueur Mauro Icardi ?	equipe d'une joueur
Quelle équipe a signé Karim Benzema ?	equipe d'une joueur
Dans quel club évolue Kai Havertz ?	equipe d'une joueur
Quelle équipe a transféré Jan Oblak ?	equipe d'une joueur
Qui est le club actuel de Marquinhos ?	equipe d'une joueur
Dans quelle équipe joue Paulo Dybala ?	equipe d'une joueur
Quelle est l'équipe du joueur Thomas Müller ?	equipe d'une joueur
À quelle équipe appartient Bruno Fernandes ?	equipe d'une joueur
Quelle équipe a recruté Son Heung-min ?	equipe d'une joueur
Qui est l'équipe actuelle du joueur Ángel Di María ?	equipe d'une joueur
Quelle équipe a signé Thiago Alcântara ?	equipe d'une joueur
Dans quel club évolue Thiago Silva ?	equipe d'une joueur
Quelle équipe a transféré Paul Pogba ?	equipe d'une joueur
Qui est le club actuel de Joshua Kimmich ?	equipe d'une joueur
Dans quelle équipe joue Marcus Rashford ?	equipe d'une joueur
Quelle est l'équipe du joueur Frenkie de Jong ?	equipe d'une joueur
À quelle équipe appartient Raheem Sterling ?	equipe d'une joueur
Quelle équipe a recruté Jadon Sancho ?	equipe d'une joueur
Qui est l'équipe actuelle du joueur Kalidou Koulibaly ?	equipe d'une joueur
Quelle équipe a signé Héctor Bellerín ?	equipe d'une joueur
Générer un graphique linéaire pour montrer l'évolution des buts d'Ibrahimovic de 2005 à 2020.	affiche graphe joueur
Affichez le nombre total de buts marqués par Ibrahimovic pour chaque saison entre 2005 et 2020.	affiche graphe joueur
Montrez-moi la progression des buts d'Ibrahimovic au cours des quinze dernières saisons.	affiche graphe joueur
Quel joueur a marqué le plus de buts pendant la période de 2005 à 2020 ?	affiche graphe joueur
Affichez la courbe d'évolution des buts de Aguero de 2010 à 2022.	affiche graphe joueur
Pouvez-vous générer un graphe montrant le nombre de buts marqués par Aguero pour chaque saison depuis 2010 ?	affiche graphe joueur
Montrez-moi la tendance des buts de Aguero au fil des saisons de 2010 à 2022.	affiche graphe joueur
Afficher le graphique en barres des buts de Aguero pour les années allant de 2010 à 2022.	affiche graphe joueur
J'aimerais voir un diagramme représentant l'évolution des buts marqués par Aguero entre 2010 et 2022.	affiche graphe joueur
Générer un graphique linéaire pour montrer l'évolution des buts de Kane de 2013 à 2021.	affiche graphe joueur
Affichez le nombre total de buts marqués par Kane pour chaque saison entre 2013 et 2021.	affiche graphe joueur
Montrez-moi la progression des buts de Kane au cours des huit dernières saisons.	affiche graphe joueur
Quel joueur a connu la plus forte augmentation du nombre de buts entre 2013 et 2021 ?	affiche graphe joueur
Comparez graphiquement les performances de Messi, Ronaldo, Neymar, Hazard, Salah, Mbappé, Benzema, Suarez, Ibrahimovic et Kane en termes de buts de 2013 à 2021.	affiche graphe joueur
Affichez la courbe d'évolution des buts de De Bruyne de 2012 à 2020.	affiche graphe joueur
Pouvez-vous générer un graphe montrant le nombre de buts marqués par De Bruyne pour chaque saison depuis 2012 ?	affiche graphe joueur
Montrez-moi la tendance des buts de De Bruyne au fil des saisons de 2012 à 2020.	affiche graphe joueur
Afficher le graphique en barres des buts de De Bruyne pour les années allant de 2012 à 2020.	affiche graphe joueur
J'aimerais voir un diagramme représentant l'évolution des buts marqués par De Bruyne entre 2012 et 2020.	affiche graphe joueur
Générer un graphique linéaire pour montrer l'évolution des buts de Griezmann de 2011 à 2021.	affiche graphe joueur
Affichez le nombre total de buts marqués par Griezmann pour chaque saison entre 2011 et 2021.	affiche graphe joueur
Montrez-moi la progression des buts de Griezmann au cours des dix dernières saisons.	affiche graphe joueur
Quel joueur a connu la plus forte baisse du nombre de buts entre 2011 et 2021 ?	affiche graphe joueur
Comparez graphiquement les performances de Messi, Ronaldo, Neymar, Hazard, Salah, Mbappé, Benzema, Suarez, Ibrahimovic, Kane, De Bruyne et Griezmann en termes de buts de 2011 à 2021.	affiche graphe joueur
Affichez la courbe d'évolution des buts de Sterling de 2013 à 2022.	affiche graphe joueur
Pouvez-vous générer un graphe montrant le nombre de buts marqués par Sterling pour chaque saison depuis 2013 ?	affiche graphe joueur
Montrez-moi la tendance des buts de Sterling au fil des saisons de 2013 à 2022.	affiche graphe joueur
Afficher le graphique en barres des buts de Sterling pour les années allant de 2013 à 2022.	affiche graphe joueur
J'aimerais voir un diagramme représentant l'évolution des buts marqués par Sterling entre 2013 et 2022.	affiche graphe joueur
Générer un graphique linéaire pour montrer l'évolution des buts de Müller de 2010 à 2020.	affiche graphe joueur
Affichez le nombre total de buts marqués par Müller pour chaque saison entre 2010 et 2020.	affiche graphe joueur
Montrez-moi la progression des buts de Müller au cours des dix dernières saisons.	affiche graphe joueur
Quel joueur a marqué le moins de buts pendant la période de 2010 à 2020 ?	affiche graphe joueur
Comparez graphiquement les performances de Messi, Ronaldo, Neymar, Hazard, Salah, Mbappé, Benzema, Suarez, Ibrahimovic, Kane, De Bruyne, Griezmann, Sterling et Müller en termes de buts de 2010 à 2020.	affiche graphe joueur
Affichez la courbe d'évolution des buts de Son de 2014 à 2021.	affiche graphe joueur
Pouvez-vous générer un graphe montrant le nombre de buts marqués par Son pour chaque saison depuis 2014 ?	affiche graphe joueur
Montrez-moi la tendance des buts de Son au fil des saisons de 2014 à 2021.	affiche graphe joueur
Afficher le graphique en barres des buts de Son pour les années allant de 2014 à 2021.	affiche graphe joueur
J'aimerais voir un diagramme représentant l'évolution des buts marqués par Son entre 2014 et 2021.	affiche graphe joueur
Générer un graphique linéaire pour montrer l'évolution des buts de Benzema de 2008 à 2016.	affiche graphe joueur
Affichez le nombre total de buts marqués par Benzema pour chaque saison entre 2008 et 2016.	affiche graphe joueur
Montrez-moi la progression des buts de Benzema au cours des huit dernières saisons.	affiche graphe joueur
Quel joueur a connu la plus forte augmentation du nombre de buts entre 2008 et 2016 ?	affiche graphe joueur
Comparez graphiquement les performances de Messi, Ronaldo, Neymar, Hazard, Salah, Mbappé, Suarez, Ibrahimovic, Kane, De Bruyne, Griezmann, Sterling, Müller et Son en termes de buts de 2008 à 2016.	affiche graphe joueur
Affichez la courbe d'évolution des buts de Di Maria de 2010 à 201	affiche graphe joueur
ffichez le graphique montrant l'évolution des buts de Messi de 2014 à 2019.	affiche graphe joueur
Pouvez-vous générer un graphe qui représente le nombre de buts marqués par Messi au cours des années 2014 à 2019 ?	affiche graphe joueur
Montrez-moi la courbe d'évolution des buts de Messi entre 2014 et 2019.	affiche graphe joueur
Quel a été le trend des buts de Messi pendant la période de 2014 à 2019 ?	affiche graphe joueur
Générer un graphique linéaire indiquant combien de buts Messi a marqués chaque année de 2014 à 2019.	affiche graphe joueur
Montrez-moi visuellement la progression du nombre de buts de Messi au fil des saisons de 2014 à 2019.	affiche graphe joueur
Afficher le graphique en barres des buts de Messi pour les années allant de 2014 à 2019.	affiche graphe joueur
J'aimerais voir un diagramme montrant l'évolution des buts marqués par Messi entre 2014 et 2019.	affiche graphe joueur
Comparez le nombre de buts de Messi pour chaque année de 2014 à 2019 en utilisant un graphique.	affiche graphe joueur
Affichez la tendance des buts de Messi entre 2014 et 2019 sous forme graphique.	affiche graphe joueur
Générez un graphique pour représenter l'évolution des buts de Ronaldo de 2012 à 2020.	affiche graphe joueur
Affichez le nombre total de buts marqués par Ronaldo pour chaque saison entre 2012 et 2020.	affiche graphe joueur
Montrez-moi la progression des buts de Ronaldo au cours des huit dernières saisons.	affiche graphe joueur
Quel joueur a marqué le plus de buts pendant la période de 2012 à 2020 ?	affiche graphe joueur
Comparez graphiquement les performances de Messi et Ronaldo en termes de buts entre 2012 et 2020.	affiche graphe joueur
Affichez la courbe d'évolution des buts de Neymar de 2015 à 2021.	affiche graphe joueur
Pouvez-vous générer un graphe montrant le nombre de buts marqués par Neymar pour chaque saison depuis 2015 ?	affiche graphe joueur
Montrez-moi la tendance des buts de Neymar au fil des saisons de 2015 à 2021.	affiche graphe joueur
Afficher le graphique en barres des buts de Neymar pour les années allant de 2015 à 2021.	affiche graphe joueur
J'aimerais voir un diagramme représentant l'évolution des buts marqués par Neymar entre 2015 et 2021.	affiche graphe joueur
Générer un graphique linéaire pour montrer l'évolution des buts de Hazard de 2013 à 2019.	affiche graphe joueur
Affichez le nombre total de buts marqués par Hazard pour chaque saison entre 2013 et 2019.	affiche graphe joueur
Montrez-moi la progression des buts de Hazard au cours des six dernières saisons.	affiche graphe joueur
Quel joueur a connu la plus forte augmentation du nombre de buts entre 2013 et 2019 ?	affiche graphe joueur
Comparez graphiquement les performances de Messi, Ronaldo, Neymar et Hazard en termes de buts de 2013 à 2019.	affiche graphe joueur
Affichez la courbe d'évolution des buts de Salah de 2016 à 2022.	affiche graphe joueur
Pouvez-vous générer un graphe montrant le nombre de buts marqués par Salah pour chaque saison depuis 2016 ?	affiche graphe joueur
Montrez-moi la tendance des buts de Salah au fil des saisons de 2016 à 2022.	affiche graphe joueur
Afficher le graphique en barres des buts de Salah pour les années allant de 2016 à 2022.	affiche graphe joueur
J'aimerais voir un diagramme représentant l'évolution des buts marqués par Salah entre 2016 et 2022.	affiche graphe joueur
Générer un graphique linéaire pour montrer l'évolution des buts de Mbappé de 2017 à 2023.	affiche graphe joueur
Affichez le nombre total de buts marqués par Mbappé pour chaque saison entre 2017 et 2023.	affiche graphe joueur
Montrez-moi la progression des buts de Mbappé au cours des sept dernières saisons.	affiche graphe joueur
Quel joueur a marqué le moins de buts pendant la période de 2017 à 2023 ?	affiche graphe joueur
Comparez graphiquement les performances de Messi, Ronaldo, Neymar, Hazard, Salah et Mbappé en termes de buts de 2017 à 2023.	affiche graphe joueur
Affichez la courbe d'évolution des buts de Lewandowski de 2014 à 2020.	affiche graphe joueur
Pouvez-vous générer un graphe montrant le nombre de buts marqués par Lewandowski pour chaque saison depuis 2014 ?	affiche graphe joueur
Montrez-moi la tendance des buts de Lewandowski au fil des saisons de 2014 à 2020.	affiche graphe joueur
Afficher le graphique en barres des buts de Lewandowski pour les années allant de 2014 à 2020.	affiche graphe joueur
J'aimerais voir un diagramme représentant l'évolution des buts marqués par Lewandowski entre 2014 et 2020.	affiche graphe joueur
Générer un graphique linéaire pour montrer l'évolution des buts de Benzema de 2010 à 2018.	affiche graphe joueur
Affichez le nombre total de buts marqués par Benzema pour chaque saison entre 2010 et 2018.	affiche graphe joueur
Montrez-moi la progression des buts de Benzema au cours des neuf dernières saisons.	affiche graphe joueur
Quel joueur a connu la plus forte baisse du nombre de buts entre 2010 et 2018 ?	affiche graphe joueur
Comparez graphiquement les performances de Messi, Ronaldo, Neymar, Hazard, Salah, Mbappé et Benzema en termes de buts de 2010 à 2018.	affiche graphe joueur
Affichez la courbe d'évolution des buts de Suarez de 2012 à 2019.	affiche graphe joueur
Pouvez-vous générer un graphe montrant le nombre de buts marqués par Suarez pour chaque saison depuis 2012 ?	affiche graphe joueur
Montrez-moi la tendance des buts de Suarez au fil des saisons de 2012 à 2019.	affiche graphe joueur
Afficher le graphique en barres des buts de Suarez pour les années allant de 2012 à 2019.	affiche graphe joueur
Pouvez-vous générer un graphe montrant le nombre de buts marqués par Di Maria pour chaque saison depuis 2010 ?	affiche graphe joueur
Montrez-moi la tendance des buts de Di Maria au fil des saisons de 2010 à 2021.	affiche graphe joueur
Afficher le graphique en barres des buts de Di Maria pour les années allant de 2010 à 2021.	affiche graphe joueur
J'aimerais voir un diagramme représentant l'évolution des buts marqués par Di Maria entre 2010 et 2021.	affiche graphe joueur
Générer un graphique linéaire pour montrer l'évolution des buts de Salah de 2014 à 2022.	affiche graphe joueur
Affichez le nombre total de buts marqués par Salah pour chaque saison entre 2014 et 2022.	affiche graphe joueur
Montrez-moi la progression des buts de Salah au cours des huit dernières saisons.	affiche graphe joueur
Quel joueur a marqué le plus de buts pendant la période de 2014 à 2022 ?	affiche graphe joueur
Comparez graphiquement les performances de Messi, Ronaldo, Neymar, Hazard, Mbappé, Suarez, Ibrahimovic, Kane, De Bruyne, Griezmann, Sterling, Müller, Son et Di Maria en termes de buts de 2014 à 2022.	affiche graphe joueur
Affichez la courbe d'évolution des buts de Benzema de 2006 à 2015.	affiche graphe joueur
Pouvez-vous générer un graphe montrant le nombre de buts marqués par Benzema pour chaque saison depuis 2006 ?	affiche graphe joueur
Montrez-moi la tendance des buts de Benzema au fil des saisons de 2006 à 2015.	affiche graphe joueur
Afficher le graphique en barres des buts de Benzema pour les années allant de 2006 à 2015.	affiche graphe joueur
J'aimerais voir un diagramme représentant l'évolution des buts marqués par Benzema entre 2006 et 2015.	affiche graphe joueur
Générer un graphique linéaire pour montrer l'évolution des buts de Mbappé de 2015 à 2023.	affiche graphe joueur
Affichez le nombre total de buts marqués par Mbappé pour chaque saison entre 2015 et 2023.	affiche graphe joueur
Montrez-moi la progression des buts de Mbappé au cours des neuf dernières saisons.	affiche graphe joueur
Quel joueur a connu la plus forte augmentation du nombre de buts entre 2015 et 2023 ?	affiche graphe joueur
Comparez graphiquement les performances de Messi, Ronaldo, Neymar, Hazard, Suarez, Ibrahimovic, Kane, De Bruyne, Griezmann, Sterling, Müller, Son, Di Maria et Benzema en termes de buts de 2015 à 2023.	affiche graphe joueur
Affichez la courbe d'évolution des buts de Lewandowski de 2011 à 2021.	affiche graphe joueur
Pouvez-vous générer un graphe montrant le nombre de buts marqués par Lewandowski pour chaque saison depuis 2011 ?	affiche graphe joueur
Montrez-moi la tendance des buts de Lewandowski au fil des saisons de 2011 à 2021.	affiche graphe joueur
Afficher le graphique en barres des buts de Lewandowski pour les années allant de 2011 à 2021.	affiche graphe joueur
J'aimerais voir un diagramme représentant l'évolution des buts marqués par Lewandowski entre 2011 et 2021.	affiche graphe joueur
Générer un graphique linéaire pour montrer l'évolution des buts de Neymar de 2013 à 2022.	affiche graphe joueur
Affichez le nombre total de buts marqués par Neymar pour chaque saison entre 2013 et 2022.	affiche graphe joueur
Montrez-moi la progression des buts de Neymar au cours des neuf dernières saisons.	affiche graphe joueur
Quel joueur a marqué le moins de buts pendant la période de 2013 à 2022 ?	affiche graphe joueur
Comparez graphiquement les performances de Messi, Ronaldo, Hazard, Salah, Mbappé, Suarez, Ibrahimovic, Kane, De Bruyne, Griezmann, Sterling, Müller, Son, Di Maria, Benzema et Lewandowski en termes de buts de 2013 à 2022.	affiche graphe joueur
Affichez la courbe d'évolution des buts de Vardy de 2012 à 2020.	affiche graphe joueur
Pouvez-vous générer un graphe montrant le nombre de buts marqués par Vardy pour chaque saison depuis 2012 ?	affiche graphe joueur
Montrez-moi la tendance des buts de Vardy au fil des saisons de 2012 à 2020.	affiche graphe joueur
Afficher le graphique en barres des buts de Vardy pour les années allant de 2012 à 2020.	affiche graphe joueur
J'aimerais voir un diagramme représentant l'évolution des buts marqués par Vardy entre 2012 et 2020.	affiche graphe joueur
Générer un graphique linéaire pour montrer l'évolution des buts de Sterling de 2012 à 2021.	affiche graphe joueur
Affichez le nombre total de buts marqués par Sterling pour chaque saison entre 2012 et 2021.	affiche graphe joueur
Montrez-moi la progression des buts de Sterling au cours des neuf dernières saisons.	affiche graphe joueur
Quel joueur a connu la plus forte augmentation du nombre de buts entre 2012 et 2021 ?	affiche graphe joueur
Comparez graphiquement les performances de Messi, Ronaldo, Neymar, Hazard, Salah, Mbappé, Suarez, Ibrahimovic, Kane, De Bruyne, Griezmann, Müller, Son, Di Maria, Benzema, Lewandowski et Vardy en termes de buts de 2012 à 2021.	affiche graphe joueur
Affichez la courbe d'évolution des buts de Firmino de 2013 à 2022.	affiche graphe joueur
Pouvez-vous générer un graphe montrant le nombre de buts marqués par Firmino pour chaque saison depuis 2013 ?	affiche graphe joueur
Montrez-moi la tendance des buts de Firmino au fil des saisons de 2013 à 2022.	affiche graphe joueur
Afficher le graphique en barres des buts de Firmino pour les années allant de 2013 à 2022.	affiche graphe joueur
J'aimerais voir un diagramme représentant l'évolution des buts marqués par Firmino entre 2013 et 2022.	affiche graphe joueur
Générer un graphique linéaire pour montrer l'évolution des buts de De Bruyne de 2012 à 2021.	affiche graphe joueur
Affichez la courbe d'évolution des buts de Alcantara de 2013 à 2022.	affiche graphe joueur
Pouvez-vous générer un graphe montrant le nombre de buts marqués par Alcantara pour chaque saison depuis 2013 ?	affiche graphe joueur
Montrez-moi la tendance des buts de Alcantara au fil des saisons de 2013 à 2022.	affiche graphe joueur
Afficher le graphique en barres des buts de Alcantara pour les années allant de 2013 à 2022.	affiche graphe joueur
J'aimerais voir un diagramme représentant l'évolution des buts marqués par Alcantara entre 2013 et 2022.	affiche graphe joueur
Générer un graphique linéaire pour montrer l'évolution des buts de Salah de 2014 à 2023.	affiche graphe joueur
Affichez le nombre total de buts marqués par Salah pour chaque saison entre 2014 et 2023.	affiche graphe joueur
Montrez-moi la progression des buts de Salah au cours des dix dernières saisons.	affiche graphe joueur
Quel joueur a connu la plus forte augmentation du nombre de buts entre 2014 et 2023 ?	affiche graphe joueur
Comparez graphiquement les performances de Messi, Ronaldo, Neymar, Hazard, Mbappé, Suarez, Ibrahimovic, Kane, Griezmann, Müller, Son, Di Maria, Benzema, Lewandowski, Vardy, Firmino, Sancho, Silva, Ramos, Varane et Alcantara en termes de buts de 2014 à 2023.	affiche graphe joueur
Affichez la courbe d'évolution des buts de Pique de 2007 à 2021.	affiche graphe joueur
Pouvez-vous générer un graphe montrant le nombre de buts marqués par Pique pour chaque saison depuis 2007 ?	affiche graphe joueur
Montrez-moi la tendance des buts de Pique au fil des saisons de 2007 à 2021.	affiche graphe joueur
Afficher le graphique en barres des buts de Pique pour les années allant de 2007 à 2021.	affiche graphe joueur
J'aimerais voir un diagramme représentant l'évolution des buts marqués par Pique entre 2007 et 2021.	affiche graphe joueur
Générer un graphique linéaire pour montrer l'évolution des buts de De Jong de 2015 à 2023.	affiche graphe joueur
Affichez le nombre total de buts marqués par De Jong pour chaque saison entre 2015 et 2023.	affiche graphe joueur
Montrez-moi la progression des buts de De Jong au cours des huit dernières saisons.	affiche graphe joueur
Quel joueur a marqué le plus de buts pendant la période de 2015 à 2023 ?	affiche graphe joueur
Comparez graphiquement les performances de Messi, Ronaldo, Neymar, Hazard, Salah, Mbappé, Suarez, Ibrahimovic, Kane, Griezmann, Müller, Son, Di Maria, Benzema, Lewandowski, Vardy, Firmino, Sancho, Silva, Ramos, Varane, Alcantara, et Pique en termes de buts de 2015 à 2023.	affiche graphe joueur
Affichez la courbe d'évolution des buts de Neuer de 2010 à 2022.	affiche graphe joueur
Pouvez-vous générer un graphe montrant le nombre de buts marqués par Neuer pour chaque saison depuis 2010 ?	affiche graphe joueur
Montrez-moi la tendance des buts de Neuer au fil des saisons de 2010 à 2022.	affiche graphe joueur
Afficher le graphique en barres des buts de Neuer pour les années allant de 2010 à 2022.	affiche graphe joueur
J'aimerais voir un diagramme représentant l'évolution des buts marqués par Neuer entre 2010 et 2022.	affiche graphe joueur
Générer un graphique linéaire pour montrer l'évolution des buts de Casemiro de 2012 à 2021.	affiche graphe joueur
Affichez le nombre total de buts marqués par Casemiro pour chaque saison entre 2012 et 2021.	affiche graphe joueur
Montrez-moi la progression des buts de Casemiro au cours des dix dernières saisons.	affiche graphe joueur
Quel joueur a connu la plus forte augmentation du nombre de buts entre 2012 et 2021 ?	affiche graphe joueur
Comparez graphiquement les performances de Messi, Ronaldo, Neymar, Hazard, Salah, Mbappé, Suarez, Ibrahimovic, Kane, Griezmann, Müller, Son, Di Maria, Benzema, Lewandowski, Vardy, Firmino, Sancho, Silva, Ramos, Varane, Alcantara, Pique et Neuer en termes de buts de 2012 à 2021.	affiche graphe joueur
Affichez la courbe d'évolution des buts de Courtois de 2011 à 2022.	affiche graphe joueur
Pouvez-vous générer un graphe montrant le nombre de buts marqués par Courtois pour chaque saison depuis 2011 ?	affiche graphe joueur
Montrez-moi la tendance des buts de Courtois au fil des saisons de 2011 à 2022.	affiche graphe joueur
Afficher le graphique en barres des buts de Courtois pour les années allant de 2011 à 2022.	affiche graphe joueur
J'aimerais voir un diagramme représentant l'évolution des buts marqués par Courtois entre 2011 et 2022.	affiche graphe joueur
Générer un graphique linéaire pour montrer l'évolution des buts de Benzema de 2009 à 2018.	affiche graphe joueur
Affichez le nombre total de buts marqués par Benzema pour chaque saison entre 2009 et 2018.	affiche graphe joueur
Montrez-moi la progression des buts de Benzema au cours des dix dernières saisons.	affiche graphe joueur
Quel joueur a marqué le moins de buts pendant la période de 2009 à 2018 ?	affiche graphe joueur
Comparez graphiquement les performances de Messi, Ronaldo, Neymar, Hazard, Salah, Mbappé, Suarez, Ibrahimovic, Kane, Griezmann, Müller, Son, Di Maria, Lewandowski, Vardy, Firmino, Sancho, Silva, Ramos, Varane, Alcantara, Pique, Neuer, Casemiro et Courtois en termes de buts de 2009 à 2018.	affiche graphe joueur